11111111111111111111111111111111111111111111111111111111111111
11111111111111111111000000000000000000000000000000000000011111
10011111111111100000000000000111111111111111111111000000001111
10000000000000000000000000000000000000000000000000000000000001
10000000000000000000000111111111111100000011111111111111111111
10001111100000000000000000000000000000000000000000000000111111
10000000000000000000011111111111111111110E00000000000000011111
10001110000000000000011111111111111111110000000000000000000011
10001100000001000000000000011111111100000000000000000000000001
10000110000011000000000000011111111100000011111111110000000001
10000000000011000000000000001111111100000000000011111100000001
10000000000011000000000000000111100000000000000000000000000001
1110000000001000000000000000000000000000000C100000000000000001
111000000P0000000000000111111111110000000000100000000000001111
11100000000010000000000000111000000000000000000000000000011111
11111100000011000000000000000000000000000000000001111111111111
11111100000011000000000000000000001111111111111111111111111111
11111110000000000000000000000000111111111111111111111111111111
11111111111111111111111111111111111111111111111111111111111111
