1111111111111111111111
1P00000000000000000001
1000000000000000000001
1000000000000000000001
10CCCCCCCCCCCCCCCCCC01
1100000000000000000001
1C10000000000000000E01
1111111111111111111111
