1111111111111111
10P0000000000001
1000000000000001
1000000C00000001
1000000000000E01
1000000000000001
1111111111111111

