
1111111111111111111
10P0000000000000001
1000000000000000001
1000000000000000001
10E00000000C0000001
1000000000000000001
1000000000000000001
1111111111111111111
