111111111111111111111111
1P1000000000000000000001
11000000000E000000000001
100000000000000000000001
1000000000000C0000000001
100000000000000000000001
111111111111111111111111
