11111111111111111111
100000000000000001C1
10P00000000000000011
10000000000000000001
10000E00000000000001
10000000000000000001
10000000000000000001
11111111111111111111
