111111111111111
10P000000000001
100000000000001
10000E00C00001
100000000000001
111111111111111
